1111111111
0000001111
0000000001
1111111101
1111111101
1111111101
1111111100
11E1111111
110000000*
1111111111